DDDDDDDDDDDDDDDDDDDDDDDDDDDDDDDDDDDDDDDD
D                                      D
D                                      D
D                                      D
D                                      D
D                                      D
D                                      D
D                                      D
D                                      D
D                                      D
D                                      D
D                                      D
D                                      D
D                                      D
D                                      D
D                                      D
D                                      D
D                                      D
D                                      D
D                                      D
D                                      D
D                                      D
D                                      D
D                                      D
D                                      D
D                                      D
D                                      D
D                                      D
D                                      D
D                                      D
D                                      D
D                                      D
D                                      D
D                                      D
D                                      D
D                                      D
D                                      D
DGGGGGGGGGGGGGGGGGGGGGGGGGGGGGGGGGGGGGGD
DDDDDDDDDDDDDDDDDDDDDDDDDDDDDDDDDDDDDDDD
DDDDDDDDDDDDDDDDDDDDDDDDDDDDDDDDDDDDDDDD