DDDDDDDDDDDDDDDDDDDDDDDDDDDDDDDDDDDDDDDD
D                                      D
D                                    W D
D    GGG B GGGG                  GGG   D
D     DDGGGD  DGGGGG        GGGGGDDDGGGD
D                  DGG B GGGDDDDDD DDDDD
DG                   DGGGDD         DDDD
DDGG                                 DDD
DDDD   F   F  GGG                     DD
DDDDLLLLLLLLLLDDDG                     D
DDDDLLDDDDDDDDD                        D
DDDDDDD                GGG             D
DD                   GGDDDGG           D
D  H     GGG        GDDD DDDGGG        D
D        DDD     GGGDD D    DDDGG      D
D  G   GGDDDGG B DDDD                  D
DGGDGGGDDD DDDGGGD                     D
DDDD     D   DDDD                      D
DD             D         B   GGG      GD
D                     GGGGGGGDDDGG H GDD
D  GG               GGDDD DDD DDDDGGGDDD
D  DDG  GG             D    D  DD  DDDDD
DGGDDDGGDDG                     D   DD D
DDDDD D D        F                     D
DD  D                                  D
D           F                          D
D                                      D
D  G                                   D
DGGDGG                                GD
DDDDDDGG        F        B         BGGDD
DDD                    GGGGGLLLGGGGGDDDD
DD                   GGDDDDDDDDDDDDDDDDD
D           F         DDDDD DDD  DDDDDDD
D                      DD            DDD
D      GG              DD             DD
D    GGDD      GGGG    D               D
D   GDDDDG  B GDDDDG         GG        D
DGGGDDDDDDGGGGDDDDDDG     GGGDDGGG     D
DDDDDDDDDDDDDDDDDDDDDGGGGGDDDDDDDDGG H D
DDDDDDDDDDDDDDDDDDDDDDDDDDDDDDDDDDDDGGGD